30
30
999911009999999999999999109999
999911009999999999999999109999
999911009999999999999999109999
999911009999999999999999109999
999911009999999999999999109999
999911009999999999999999109999
333344443333333333333333443333
333344443433333333333333443333
999911009199999999999999109999
999911009193333333333319109999
999911009190999999999919109999
999911009190912222222229109999
999911009190919999999999109999
999911009190919999999333109999
999911009190919999999909109999
999911009190933333333309109999
999911009190999999999999109999
999911009190222222222229109999
999911009199999999999909109999
999911009333333333333309109999
999911009999999999999999109999
222244442222222222222222442222
222244442222222222222222442222
222244442222222222222222442222
333344443333333333333333443333
333344443333333333333333443333
333344443433333333333333443333
999911009199999999999999109999
999911009333333333333333109999
999911009999999999999999109999
6
5
5
10
0
6
3
6
10
1
6
3
7
10
1
6
6
8
10
0
6
7
8
10
0
6
23
6
10
1
6
23
7
10
1
6
3
24
10
1
6
3
25
10
1
6
3
26
10
1
6
8
21
10
1
6
8
22
10
1
6
8
23
10
1
6
26
21
10
1
6
26
22
10
1
6
26
23
10
1
6
23
24
10
1
6
23
25
10
1
6
23
26
10
1
6
6
27
10
0
6
7
27
10
0
6
4
20
10
0
6
5
20
10
0
6
4
5
10
0
7
5
5
10
7
3
6
10
7
3
7
10
7
6
8
10
7
12
28
5
8
4
0
20
8
5
0
25
8
0
6
25
8
0
7
25
8
0
24
30
8
0
25
15
8
0
26
30
8
29
21
20
8
29
22
25
8
29
23
30
8
6
29
20
8
7
29
25
8
24
0
30
8
25
29
35
8
21
13
10
10
15
25
1
10
15
26
1
10
15
23
1
10
15
24
1
10
15
22
1
10
15
21
1
10
6
13
2
-1
